?.......
.???????
.???.???
.??.????
.????.??
.?.?????
.??????.
.?????.?
.??.????
.???.???