?.......
.???????
.????.??
.?.?????
.????.??
.??.???.
.???.???
.?????.?
.??.????
.???????
