?.......
.???????
.????.??
.???.???
.??.???.
.?????.?
.?.?????
.????.??
.???????
.??.????
