?.......
.???????
.????.??
.???.???
.??.????
.?.????.
.?????.?
.??.????
.???????
.????.??
