?.......
.???????
.??.????
.???.???
.????.??
.?.???.?
.??????.
.??.????
.???.???
.????.??
