?.......
.???????
.????.??
.??.????
.???.???
.?.????.
.?????.?
.???????
.??.????
.????.??
