?.......
.???????
.??.????
.???.???
.?.?????
.????.??
.?????.?
.??.????
.???????
.????.??
