?.......
.???????
.????.??
.???????
.??.???.
.???.???
.???????
.?.?????
.????.??
.??.????
