?.......
.???????
.????.??
.???.???
.?.????.
.?????.?
.????.??
.??.????
.???????
.???.???
