?.......
.???????
.??.????
.?????.?
.?.????.
.????.??
.??.????
.?????.?
.?.?????
.???.???
