?.......
.???????
.???.???
.????.??
.?????.?
.??.????
.???.??.
.?.??.??
.???.???
.??.????
