?.......
.???????
.????.??
.?.?????
.????.??
.??????.
.?.?????
.???.???
.???????
.??.????
